1111111111111
1C01000P000C1
1000011111001
1PC011E000C01
1111111111111
