11111111111111111111111111111111111111111111111
1000E000000000000000000000000000000000000000001
10000000000000000000000000000000000000000000001
1000000000000000C000000000C00000000000000000001
10000000000000000000000000000000000000000C00001
10000000000000000000000000000000000000000000001
10000C0000000000000000000C000000000000000C00001
10000000000000000000000000000000000000000000001
10000000000000000000000000000000000000000000001
10000000000000000000000000000000000000000000001
1000000000000000C00000000000000C000000000000001
10000000000000000000000000000000000000000000001
10000000000000000000000000000000000000000000001
10000000000000000000000000000000000000000C00001
1000000000000000000000000000000000000000C000001
10000000000000000000000000000000000000000000001
10000000000000000000000000C000000C0000000000001
1000P000000000000000000000000000000000000000001
1C000000000000000000000000000000000000000000001
11111111111111111111111111111111111111111111111
