11111111111111111111111111111111111111111111111111111111111111111111111111111111111111111111111
11110000000000000000000000000000000000000000000000000000000000000000000000000000000000000011111
11110000000000000000000000000000000000000000000000000000000000000000000000000000000000000000111
1111P00000000000000000000000000000000000000000000E000000000000CCCCC0000000000000000000000000111
11111111111111111111111111111111111111111111111111111111111111111111111111111111111111111111111
