1111111111111111111111111111111
1111111111110000000000111110011
11110000E0111000000000011110011
1111111000000000000000000000001
1000000000000000000000000000001
1000000001111111000000000000101
1000000000011111000000000000101
1000000011111111000000000001101
1111100000000000000000000000001
1000000000000000000000000000001
1000000000000000000000000000001
1000000000000000000000000000001
1000000000000000000000000000001
10000000P0000000000000000000001
1000000000000000000000000000001
1000000000000000000000000000001
1000000000000000000000000000001
1C000000000000000000000000000C1
1111111111111111111111111111111
