11111111111111111111111111111111111111111111111111
11000000000000000000000000000000C00000000000000001
11000000000000000000000000C0C0C00000C0C00000000001
1000000000000000C0C000C0C0C00C000CC0C0C00000000001
1000000000C0000000CC0CCC00C0C00C000CC0000000000001
1P00000000000C00000000000000C0C00000C00C00000000E1
10000101000000C0CC0C0C0CC00000C00CC0C00C0000000001
1000001000000000000C000000C00CC0000000C00000000001
10000101000000000000000000CC0000CCC0C00C0000000001
1000000000000000000000000000C00C0C0000000000000001
11111111111111111111111111111111111111111111111111
