11111111111111111111111111111111111111111111111111
1100000000000000000000000000CCCCCCCCCC000000000001
11000000000000000000000000CCCCCCCCCCCCCC0000000001
10000000000000CCCCCCCCCCCCCCCCCCCCCCCCCC0000000001
1000000000C000CCCCCCCCCCCCCCCCCCCCCCCCCC0000000001
1P00000000000CCCCCCCCCCCCCCCCCCCCCCCCCCC00000000E1
10000101000000CCCCCCCCCCCCCCCCCCCCCCCCCC0000000001
10000010000000CCCCCCCCCCCCCCCCCCCCCCCCCC0000000001
10000101000000000000000000CCCCCCCCCCCCCC0000000001
1000000000000000000000000000CCCCCCCCCC000000000001
11111111111111111111111111111111111111111111111111
